Plateau 15 17:
    01234567890123456
000 .................
001 .................
002 .................
003 .................
004 .................
005 .................
006 ..O..............
007 ..O.O.O..........
008 ..OOOOO......xx..
009 .....O.......xX..
010 ..............X..
011 ..............X..
012 ..............X..
013 .................
014 .................
Piece 2 2:
**
.*
